1111111111111111111111111111111111111111111111111111111111111111111111111111111111111111111111111111
0000000000000000000000000000000000000000000000000000000000000000000000000000000000000000000011111111
1111111111111111111111111111111111111111111111111111111111111111111111111111111111111111111011111111
1111111111111111111111111111111100000000000000000000000000000000000000000000000000000011111011111111
1111111111111111111111111111111101111111111111111111111111111111111111111111111111111001111011111111
1111111111111111111111111111111101111111111111111111111111111111111111111111111111111100111011111111
1111111111111111111111111111111101111111111111111111111111000000000000000000000000000000011011111111
1111111111111111111111111111111100000000000000000000000000000000111111111111111111111111001011111111
1111111111111111111111111111111101111111111111111111111111000000111111111111111111110111100011111111
1111111111111111111111111111111101111111111111111111111111111111111111111111111111110111111111111111
1111111111111111111111111111111101111111111111111111111111111111111111111111111111110111111111111111
1111111111100000000000000000000001111111111111111111111111111111111111111111111111110111111111111111
1111111111101111111111111111111111100000000000000000000000000000000000000000001000000111111111111111
1111111111101111111111111000000011101111111111111111110000000000011111111111111111110111111111111111
1111111111100000000000000011111011101111111111111111111111000000011111111111111111110111111111111103
1111111111111111111111111111111000001111111111111111111111111100011111111111111111110111111111111101
1111111111111111111111111111111111101111111111111111111111111111011111111111111111110111111111111121
1111111111111111111111111111111111101111111111111111111111111111111111111111111111110111111111111101
1111111111111111111111111111111111101111111111111111111111111111111111111111111111110111111111111101
1111111111111111111111111111111111100000000000000000000000000000000000000000000000001100000000000001
1111111111111111111111111111111111111111111101111111111111111111011111111111111111110011111111111101
1111111111111111111111110000000000000000000001111111111111111111000000000000000000000011111111111101
1111111111111111111111111101111111111111111101111111111111111111011111111111111111111100000000000001
1111111111111111111111111101111111111111111100000000000000000000000000000000000000000011111111111011
1111111111111111111111111000111111111111111111111111111111111111111111111111111111111111111111111011
1111111111111111111111100000000000000000000000000000000000000000000000000000000000000000000000000011
1111111111111111111111111111111111111111111111111111111111111111111111111111111111111111111111111111
1111111111111111111111111111111111111111111111111111111111111111111111111111111111111111111111111111
1111111111111111111111111111111111111111111111111111111111111111111111111111111111111111111111111111
1111111111111111111111111111111111111111111111111111111111111111111111111111111111111111111111111111
