1111111111111111111111111111111111111111111111111111111111111111111111111111111111111111111111111111
0011011110111110110000011000000000000001111011101110011110111110000011111111111111110000000011111111
1010101000111110001111101011011111011000111010001100111101011100111001111111111111000110111000111111
1001110010111110100111110011011111011010011010101101111011101101111101111111111110011100001110011111
1011111010111110110000010111011111011011001000100001000111110001111101111111111100111001100111001111
1000000010011100111111000111011111011011100011101100010000000100111001111111111110010000000010011111
1011111011000001110000011111011110001011110011101110110111110110000000001111111111001001100100111111
1111111111111111111111111111111111111111111111111111111111111111111111101111111111100100000100111111
1100111110001111111101100000011110111111111010000000111000111100111100000111111111001111011111001111
1000111100100111111000001111001000111111110000111110110010011000111001110011111111100111011110011111
1010111001110011110011111111100010111111100111111100000111000010111001110011111111001111011111001111
1110111011111011100111110000011110111111001110000001101111101110111100000111111110011100000111100111
1110110001110011001111111111001110111110011110111111100111001110111001110011111100110001110000000111
1110110101110110011111101111001110111100111110111111110010011110110011110011111101111100000111110003
1000000100000000111111100000010000000001111110000000111000111000000100000111000001111111111111111111
1011111111111111111111111111111111111111111111111111111111111111111111111111111101100000000000000001
1011110111110111000111000000010000000100011001100001100000010000010000010000011101101100000000000001
1011110111110110010011011111000111110001010011001001001100100100100100100100111101100110000000000001
1011110000000000111001000000010000001111000110010000001000001000001000001000000001110011000000000001
1011110111110100000001011111110111111111101100111111111111111111111111111111111111111001100000000001
1000000111110101111100011111110111111110001100000000000000000000000000000000000000111100110000000001
1011111111111111111111111111111111111111111111111111111111111111111111111000000000001110011000000001
1011111011100011101111111011111111000001101111101000000010000000100111101000000000000111001100000001
1011111011001001101111111011111110011100101101100011111110111111100011101000000000000011100110000001
1011111010011100101111111011111110111110101101101011111110111111101001101000000000000000110011000001
1000000000111110001111111011111110111110101101101000001110000011101100101000000000000000011001100001
1011111010000000101111111011111110111110101101101011111110111111101110001000000000000000000000110001
1011111010111110101111111011111110011100000101001011111110111111101111001111111111111111111111111001
1011111010111110100000000000000000000001110000011000000000000000001111100000000000000000000000000001
1111111111111111111111111111111111111111111111111111111111111111111111111111111111111111111111111111







